      #####
      #   ######
      # K ##   #
      #   K    #
      #### P ###
       #   # #
       # K #U#
       #   #U#
       #####U#
           ###