          ###
      ##### ######
      #     #    #
      # K  K  KP##
      ## #UUU# ##
       # #UUU# #
       #K ### K#
       #   K   #
       #  ##   #
       #########