          ###
         ## ##
        ##UK #
        #UUU ##
        #KUK  #
        # K  ##
        #PK###
        #  #
        ## #
         ###