
        #####
        #   ###
        #K#   #
        #  ## ##
        #    K #
        # K## P#
        #UUU####
        #####