

 ### K # # K ##  K #  #
 #  K K# #K K# #K K## #
 ###K K## K K## KKK# ##
   #K K# #K K# #K K#  #
 ### K # # K ## K K#  #

           P