
         #####
         #UUU#
         ##K #
         ##P ##
         # KK #
         #   ##
         #  ##
         #####