
        #####
        #   #
        #U K###
        #U P  #
        ##K## #
         #    #
         #### #
            ###