        ######
        #UUUU#
        ##UU##
         #KK#
       ###P ####
      ##  KKK  #
      #        #
      # K ######
      #   #
      #####