
        ###
        # ####
        #    ###
       ## ##K U##
       # P K KUU#
       ## K K UU#
        #  ######
        ####