         ###
        ## ###
        # UUU#
        #  ###
       ### ##
       #    ####
       #     K #
       #  ##KK #
       #####  P#
           #####