
        ######
        #U   #
        # ## ###
        #  #   #
        #P K   #
        #    K##
        ###U  #
          #####