########################
##                    ##
#   K K K  KK  K   K   #
#   K K K K  K KK  K   #
#   K K K K  K K K K   #
#    K K  K  K K  KK   #
#    K K   KK  K   K   #
#           P          #
##                    ##
########################